EEEEEEEEEEEEEEEEEEEEEEEEEEEEEE
EEEEEEEEEEEEEEEEEEEEEEEEEEEEEE
ESEE##########EE##########EESE
ESEE##########EE##########EESE
ESEEEEEEEEEEEEEEEEEEEEEEEEEESE
ESEEEEEEEEEEEEEEEEEEEEEEEEEESE
ESEE##########EE##########EESE
ESEE##########EE##########EESE
ESEEEEEEEEEEEEEEEEEEEEEEEEEESE
ESEEEEEEEEEEEEEEEEEEEEEEEEEESE
ESEE##########EE##########EESE
ESEE##########EE##########EESE
EEEEEEEEEEEEEEEEEEEEEEEEEEEEEE
EEEEEEEEEEEEEEEEEEEEEEEEEEEEEE