EEEEEEEEEEEEEEEEEEEEEEEEEEEEEEEEEEEEEEEEEEEEEEEE
ESSE##########E##########E##########E##########E
ESSE##########E##########E##########E##########E
ESSEEEEEEEEEEEEEEEEEEEEEEEEEEEEEEEEEEEEEEEEEEEEE
ESSE##########E##########E##########E##########E
ESSE##########E##########E##########E##########E
ESSEEEEEEEEEEEEEEEEEEEEEEEEEEEEEEEEEEEEEEEEEEEEE
ESSE##########E##########E##########E##########E
ESSE##########E##########E##########E##########E
ESSEEEEEEEEEEEEEEEEEEEEEEEEEEEEEEEEEEEEEEEEEEEEE
ESSE##########E##########E##########E##########E
ESSE##########E##########E##########E##########E
ESSEEEEEEEEEEEEEEEEEEEEEEEEEEEEEEEEEEEEEEEEEEEEE
ESSE##########E##########E##########E##########E
ESSE##########E##########E##########E##########E
EEEEEEEEEEEEEEEEEEEEEEEEEEEEEEEEEEEEEEEEEEEEEEEE