EEEEEEEEEEEEEEEEEEEEEEEEEEEEEE
EEEEEEEEEEEEEEEEEEEEEEEEEEEEEE
EESSEE##########EE##########EE
EESSEE##########EE##########EE
EESSEEEEEEEEEEEEEEEEEEEEEEEEEE
EESSEEEEEEEEEEEEEEEEEEEEEEEEEE
EESSEE##########EE##########EE
EESSEE##########EE##########EE
EESSEEEEEEEEEEEEEEEEEEEEEEEEEE
EESSEEEEEEEEEEEEEEEEEEEEEEEEEE
EESSEE##########EE##########EE
EESSEE##########EE##########EE
EEEEEEEEEEEEEEEEEEEEEEEEEEEEEE
EEEEEEEEEEEEEEEEEEEEEEEEEEEEEE